1111111111111111111111111111111111
100E000000C0000C00000C000000000001
1100010100000000101001000000010101
1110010010101010001001000000010101
1P0000001C00C0000000000000000000C1
1111111111111111111111111111111111