1111111111111111111111111111111111
100E000000C0000C00000C000000000001
110001010000000010100100P000010101
1110010010101010001001000000010111
10000001C00C0000000000000000000C11
1111111111111111111111111111111111