1111111111111111111111111111111111
1000000000C0000C00000C000000000001
1100010100000000001001000000010101
1110010010101010E01001000000010111
1P000001C00C0000000000000000000C11
1111111111111111111111111111111111