1111111111111111111111111111111111
10PCE00000000000000000000000000001
1111111111111111111111111111111111