1111111111111111111111111111111111
10100C01C000C000C10C0010C001000C01
1C00010111111001010000111011000011
101111010C001001C1C00C001010001001
1000C1010000110001110110C01C011001
10111100010000C0010C0100001111C001
1C1000010111111111000100100C100011
10111C010CP00C00010001011000101001
1010CC01111111110110110100111010C1
1C1010C00C00C001001010010010001110
101111110001000100101011E0100C0001
1000C0011111010100C010C11111110101
1C0010010C01C101011111111C0000C001
11111001100101011100C0000000010001
100C0000C0000100C00110001001001CC1
1111111111111111111111111111111111